111111111111	
100000000111	
100111010011
102333000011	
100333332001	
100002112101	
102120002001	
110401112101	
111111110001	
191111111111